{
  "levels": [
    {
      "name": "Garden",
      "tile_size": 12,
      "palette": {
        "1": "GREEN",
        "2": "BROWN",
        "3": "DARK_BLUE",
        "4": "YELLOW"
      },
      "tiles": [
        "1111111111111111",
        "1..............1",
        "1..2222...4....1",
        "1..2..2........1",
        "1..2..2...333..1",
        "1..2222...333..1",
        "1..............1",
        "1....2222......1",
        "1..............1",
        "1..............1",
        "1..............1",
        "1111111111111111"
      ]
    },
    {
      "name": "Catacombs",
      "tile_size": 12,
      "palette": {
        "1": "DARK_GRAY",
        "2": "LIGHT_GRAY",
        "3": "INDIGO",
        "4": "PEACH"
      },
      "tiles": [
        "1111111111111111",
        "1.2..3.....2.4.1",
        "1..............1",
        "1.....1111.....1",
        "1.....1..1.....1",
        "1.....1..1.....1",
        "1.....1111.....1",
        "1.3............1",
        "1.....2222.....1",
        "1.4............1",
        "1.........3..2.1",
        "1111111111111111"
      ]
    }
  ]
}
